1111111111111111111111111111111111
1E1000000000000C00000C00X000000001
101001010010000010100100000001X101
1000010010101010001001000000010101
1P1000000C00CX000000000000000000C1
1111111111111111111111111111111111