1111111111111111111
100001000C100011001
1000P00100100001011
1100000110001110101
1100000110001110001
1100000110001110001
1100000110001110001
100001000C100E01001
1111111111111111111